MMMMMMMMMMMMMMMMMMMMMMMMM
M                       M
MMMMMMM MMMMM MMMM MMMM M
M                       M
MMMMMMMMMM MMMMMMMMMMMMMM
M      MMM MM           M
MMMM M        MM MMM M MM
M  M MMMMMMMMMMM MMM M  M
M  M           M MMM M  M
M  MMMMM MMMMMMM MMM MMMM
M                       M
M MMMMMMMMM MMMMMM MMMMMM
M             MM       MM
MMMMMM MMMMMMMMMMM MMMMMM
MM MMM M                M
MM MMM M MMMMMMMMMMMMM MM
MM MMM           MMMMM MM
MM MMMMMMMMMMMM MMMMMM MM
MM                     MM
MMMMMM     MMMMMMMM MMMMM
MMMMMM MMMMMM       MMMMM
M         MMM MMMMM     M
MMMMMMMMM MMM MMMMMM    M
M                  MMMMMM
MMMMMMMMMMMMMMMMMMMMMMMMM
